11111111111111111111
11111111111111111111
11111111111111111111
11111111111111111111
11100010101000100111
11101110101101101111
11101110101101100111
11101110101101101111
11100010001101100111
11111111111111111111
11111111111111111111
11111111111111111111
11111111111111111111
11111111111111111111
11111111111111111111
11111111111111111111
11111111111111111111
11111111111111111111
11111111111111111111
11111111111111111111