11111111111111111111
10000001000000000101
10111011011101111101
10101010010100000001
10101011010111110111
10101011010000010001
10100001011111011101
10111101010001010001
10000101000101011111
10111111111101000101
10100000000001011101
10101011111101010001
10001000001111010111
10101111111000000101
10100000010011101101
11111111011010101101
10000000001010101001
11111011111010111011
10000010000000000001
11111111111111111111
